## THIS IS A LIST OF RULES FOR THE RESOLUTION OF TITLI IN CHURCH SLAVONIC
## LINES BEGINNING WITH # ARE IGNORED
## COLUMNS ARE SEPARATED BY TAB
## Symbol "." (dot) in pattern means that word break is required here
гг҃л	нгел
пⷭ҇л	по́стол
пⷭ҇тол	по́стол
пⷭ҇тѡл	по́стѡл
пⷭ҇кп	пи́скоп
пⷭ҇коп	пи́скоп
гг҃єл	нгєл
бг҃а.	Бо́га
бг҃ови.	Бо́гови
.бг҃ома́т	Богома́т
.бг҃омлад	Богомлад
.бг҃омт҃	Богома́т
бг҃ом	бо́гом
.бг҃оро́д	Богоро́д
.бг҃ꙋ.	Бо́гу
.бг҃ъ	Бо́гъ
бг҃	бог
Бг҃	Бог
.бж҃е.	Бо́же
бж҃е	боже
Бж҃е	Боже
бж҃ї	бо́жї
Бж҃ї	Бо́жї
бжⷭ҇т	боже́ст
Бжⷭ҇т	Боже́ст
бз҃и	бози
Бз҃и	Бози
.бз҃ѣ	Бозѣ
бз҃ѣ	бозѣ
Бз҃ѣ	Бозѣ
блгⷣт	благода́т
Блгⷣт	Благода́т
блгⷭ҇в	благослов
Блгⷭ҇в	Благослов
.бл҃га.	бла́га
.бл҃ги.	бла́ги
.бл҃го.	бла́го
.бл҃гъ.	бла́гъ
бл҃г	благ
Бл҃г	Благ
бл҃ж	блаж
Бл҃ж	Блаж
бл҃з	блаз
Бл҃з	Блаз
.бцⷣ	Богоро́диц
бцⷣ	богоро́диц
Бцⷣ	Богоро́диц
бчⷣ	богоро́дич
Бчⷣ	Богоро́дич
.влⷣк	Влады́к
влⷣк	влады́к
Влⷣк	Влады́к
влⷣц	влады́ц
Влⷣц	Влады́ц
влⷣч	влады́ч
Влⷣч	Влады́ч
кр҃с	кре́с
кр҃л	кре́сл
кр҃ш	креш
крⷭ҇и	креси
крⷭ҇	кре́с
гдⷭ҇а	Го́спода
гдⷭ҇ви	Го́сподеви
гдⷭ҇е	Го́споде
гдⷭ҇и	Го́споди
Гдⷭ҇	Го́спод
гдⷭ҇и́н	господи́н
гдⷭ҇и	Го́споди
гдⷭ҇к	госпо́дск
гдⷭ҇н	госпо́дн
гдⷭ҇о	господо
гдⷭ҇р	госуда́р
гдⷭ҇с	госпо́дс
гдⷭ҇ꙋ.	Го́сподꙋ
гдⷭ҇ь.	Госпо́дь
гдⷭ҇ь	госпо́дь
гдⷭ҇ѣ	Го́сподѣ
глаⷡ҇	глава̀
гл҃а	глаго́ла
Гл҃а	Глаго́ла
гл҃г	глаг
Гл҃г	Глаг
гл҃е	глаго́ле
Гл҃е	Глаго́ле
гл҃и	глаго́ли
Гл҃и	Глаго́ли
гл҃ꙋ	глаго́лꙋ
Гл҃ꙋ	Глаго́лꙋ
гл҃ъ	глаго́лъ
Гл҃ъ	Глаго́лъ
гл҃ю	глаго́лю
Гл҃ю	Глаго́лю
гл҃ѧ	глаго́лѧ
Гл҃ѧ	Глаго́лѧ
глⷡ҇а	глава̀
Глⷡ҇а	Глава̀
гпⷭ҇ж	госпож
Гпⷭ҇ж	Госпож
дваⷤ	два́жды
Дваⷤ	Два́жды
.дв҃а	Дѣ́ва
дв҃а	дѣ́ва
дв҃д	Дави́д
Дв҃д	Дави́д
дв҃и́	дѣви́
дв҃и̑	дѣви̑
.дв҃о	Дѣ́во
дв҃о	дѣ́во
дв҃ы	дѣ́вы
дв҃с	дѣ́вс
.дв҃ꙋ	Дѣ́вꙋ
дв҃ꙋ	дѣ́вꙋ
дв҃ц	дѣ́виц
дв҃ч	дѣви́ч
.дв҃ы	Дѣ́вы
дв҃ы	дѣ́вы
.дв҃ѣ	Дѣ́вѣ
дв҃ѣ	дѣ́вѣ
двⷭ҇т	дѣ́вст
Дв҃	Дѣ́в
дс҃ѣ	ду́сѣ
Дс҃	Ду́с
дх҃а	ду́ха
дх҃и	ду́хи
дх҃н	духн
дх҃о	духо
дх҃ѡ	духѡ
дх҃ꙋ	ду́хꙋ
дх҃ъ	ду́хъ
дх҃ѣ	ду́хѣ
Дх҃	Ду́х
дш҃а	душа
дш҃е.	ду́ше
дш҃е	душе
дш҃и	души
дш҃ꙋ	ду́шꙋ
дш҃ы	ду́шы
Дш҃	Душ
ѵⷢ҇л	ѵа́нгел
заⷱ҇	зача́ло
Заⷱ҇	Зача́ло
мⷬ҇к	мѧрѣ́к
рⷭ҇л	русал
і҆и҃л	І҆сра́ил
і҆и҃с	І҆исꙋ́с
кн҃г	кнѧг
кн҃же.	кнѧ́же
кн҃ж	кнѧж
кн҃з	кнѧ́з
Кн҃	Кнѧ́
кр҃с	крес
кр҃щ	крещ
крⷭ҇т	крест
Крⷭ҇т	Крест
мл҃т	моли́т
Мл҃т	Моли́т
млⷣн	младе́н
Млⷣн	Младе́н
млⷭ҇р	милосѣ́р
Млⷭ҇р	Милосѣ́р
млⷭ҇т	ми́лост
Млⷭ҇т	Ми́лост
мнⷭ҇т	монаст
Мнⷭ҇т	Монаст
мр҃і	Марі
мр҃ї	Марї
Мр҃і	Марі
Мр҃ї	Марї
мт҃е	ма́те
.мт҃и	Ма́ти
мт҃и	ма́ти
мт҃р	ма́тер
мт҃ь	ма́ть
Мт҃	Ма́т
мцⷭ҇	мѣ́сѧц
Мцⷭ҇	Мѣ́сѧц
мч҃е	му́че
Мч҃е	Му́че
мч҃є	му́чє
Мч҃є	Му́чє
мч҃н	му́чен
Мч҃н	Му́чен
мчⷭ҇н	мѣ́сѧчн
м҃-ц	четыредесѧ́тниц
мⷭ҇ц	мѣ́сѧц
Мⷭ҇ц	Мѣ́сѧц
мⷭ҇ч	мѣ́сѧч
Мⷭ҇ч	Mѣ́сѧч
нб҃а	не́ба
нб҃е	небе
нб҃о	не́бо
нб҃с	небе́с
нб҃ꙋ	не́бꙋ
нб҃ѣ	не́бѣ
Нб҃	Не́б
нбⷭ҇н	небе́сн
Нбⷭ҇н	Небе́сн
нлⷣ	недѣ́л
Нлⷣ	Недѣ́л
нн҃ѣ	ны́нѣ
Нн҃ѣ	Ны́нѣ
ѻ҆ц҃а̀	ѻ҆тца̀
Ѻ҆ц҃а̀	Ѻ҆тца̀
ѻ҆ц҃а́	ѻ҆тца́
Ѻ҆ц҃а́	Ѻ҆тца́
ѻ҆ц҃е́	ѻ҆тце́
ѻ҆ц҃е́	ѻ҆тце́
Ѻ҆ц҃е́	Ѻ҆тце́
ѻ҆ц҃ꙋ̀	ѻ҆тцꙋ̀
Ѻ҆ц҃ꙋ̀	Ѻ҆тцꙋ̀
ѻ҆ц҃ꙋ́	ѻ҆тцꙋ́
Ѻ҆ц҃ꙋ́	Ѻ҆тцꙋ́
ѻ҆ц҃ъ	ѻ҆те́цъ
Ѻ҆ц҃ъ	Ѻ҆те́цъ
ѻ҆ц҃ы̀	ѻ҆тцы̀
Ѻ҆ц҃ы̀	Ѻ҆тцы̀
ѻ҆ц҃ѣ̀	ѻ҆тцѣ̀
Ѻ҆ц҃ѣ̀	Ѻ҆тцѣ̀
ѻ҆ч҃ес	ѻ҆те́чес
Ѻ҆ч҃ес	Ѻ҆те́чес
ѻ҆ч҃єс	ѻ҆те́чєс
Ѻ҆ч҃єс	Ѻ҆те́чєс
ѻ҆ч҃е	ѻ҆́тче
Ѻ҆ч҃е	Ѻ҆тче
ѻ҆ч҃с	ѻ҆те́чес
Ѻ҆ч҃с	Ѻ҆те́чес
ѻ҆ч҃ь	ѻ҆те́чь
Ѻ҆ч҃ь	Ѻ҆те́чь
ѻ҆́ч҃а	ѻ҆́тча
Ѻ҆́ч҃а	Ѻ҆́тча
ѻ҆́ч҃ес	ѻ҆́течес
Ѻ҆́ч҃ес	Ѻ҆́течес
ѻ҆́ч҃е	ѻ҆́тче
Ѻ҆́ч҃е	Ѻ҆́тче
Ѻ҆́ч҃е	Ѻ҆́тче
ѻ҆́ч҃и	ѻ҆́тчи
Ѻ҆́ч҃и	Ѻ҆́тчи
ѻ҆́ч҃ї	ѻ҆́тчї
Ѻ҆́ч҃ї	Ѻ҆́тчї
ѻ҆́ч҃ꙋ	ѻ҆́тчꙋ
Ѻ҆́ч҃ꙋ	Ѻ҆́тчꙋ
ѻ҆́ч҃ь	ѻ҆́течь
Ѻ҆́ч҃ь	Ѻ҆́течь
ѡⷮ	ѿ
ѡ҆сщ҃а́	ѡ҆свѧща́
Ѡ҆сщ҃а́	Ѡ҆свѧща́
ѡ҆чⷭ҇т	ѡ҆чи́ст
Ѡ҆чⷭ҇т	Ѡ҆чи́ст
ѻц҃а	ѻтца
Ѻц҃а	Ѻтца
ѻц҃є	ѻтцє
ѻ҆ц҃є́	ѻ҆тцє́
Ѻц҃є	Ѻтцє
ѻц҃ꙋ	ѻтцꙋ
Ѻц҃ꙋ	Ѻтцꙋ
ѻц҃ъ	ѻтецъ
Ѻц҃ъ	Ѻтецъ
ѻц҃ы	ѻтцы
Ѻц҃ы	Ѻтцы
ѻц҃ѣ	ѻтцѣ
Ѻц҃ѣ	Ѻтцѣ
ѻч҃е	ѻтече
Ѻч҃е	Ѻтече
ѻч҃є	ѻтечє
Ѻч҃є	Ѻтечє
ѻч҃и	ѻтчи
Ѻч҃и	Ѻтчи
ѻч҃ї	ѻтчї
Ѻч҃ї	Ѻтчї
ѻц҃ъ	ѻтецъ
Ѻц҃ъ	Ѻтецъ
пл҃т	пло́т
Пл҃т	Пло́т
поⷣ	подо́бенъ
Поⷣ	Подо́бенъ
првⷣ	пра́вед
Првⷣ	Пра́вед
пречⷭ҇т	пречи́ст
Пречⷭ҇т	Пречи́ст
мⷣр	му́др
прпⷣб	преподо́б
Прпⷣб	Преподо́б
пⷣб	подо́б
прпⷣн	преподо́бн
Прпⷣн	Преподо́бн
прⷣт	предт
Прⷣт	Предт
прⷪ҇рк	проро́к
Прⷪ҇рк	Проро́к
прⷪ҇р	прор
Прⷪ҇р	Прор
прⷭ҇н	присн
Прⷭ҇н	Присн
прⷭ҇т	прест
Прⷭ҇т	Прест
пѧⷦ҇	пѧто́къ
Пѧⷦ҇	Пѧто́къ
ржⷭ҇т	рождест
Ржⷭ҇т	Рождест
рожⷭ҇т	рождест
Рожⷭ҇т	Рождест
сл҃н	со́лн
Сл҃н	Со́лн
см҃рт	сме́рт
См҃рт	Сме́рт
сн҃а	сы́на
Сн҃а	Сы́на
сн҃е	сы́не
Сн҃е	Сы́не
сн҃є	сы́нє
Сн҃є	Сы́нє
сн҃о	сыно
Сн҃о	Сыно
сн҃ѡ	сынѡ
Сн҃ѡ	Сынѡ
сн҃ꙋ	сы́нꙋ
Сн҃ꙋ	Сы́нꙋ
сн҃ъ	сы́нъ
Сн҃ъ	Сы́нъ
сн҃ы	сы́ны
Сн҃ы	Сы́ны
сн҃ѣ	сы́нѣ
Сн҃ѣ	Сы́нѣ
сп҃са.	Cпа́са
сп҃са	спаса
сп҃се	Cпа́се
сп҃сѐ	спасѐ
сп҃се́	спасе́
сп҃сє́	спасє́
сп҃си	спаси
сп҃сл	спасл
сп҃со	спасо
сп҃сѡ	спасѡ
сп҃сс	спа́сс
сп҃ст	спаст
сп҃сꙋ	спасꙋ
сп҃сш	спа́сш
сп҃съ	Спа́съ
сп҃сы	спасы
сп҃сѣ	спа́сѣ
Сп҃с	Спас
спⷭ҇л	спа́сл
Cпⷭ҇л	Cпа́сл
спⷭ҇н	спасе́н
Cпⷭ҇н	Cпасе́н
спⷭ҇т	спаст
Cпⷭ҇т	Cпаст
спⷭ҇ш	спа́сш
Cпⷭ҇ш	Cпа́сш
срⷣц	се́рдц
Срⷣц	Се́рдц
стрⷭ҇ти	стра́сти
стрⷭ҇тї	стра́стї
стрⷭ҇ть	стра́сть
стрⷭ҇т	страст
Стрⷭ҇т	Стра́ст
ст҃а.	свѧ́та
ст҃а	свѧта
ст҃е	свѧ́те
ст҃и	свѧти
ст҃і	свѧті
ст҃л	свѧти́тел
ст҃о	свѧ́то
ст҃ѡ	свѧ́тѡ
ст҃ꙋ	свѧ́тꙋ
ст҃ъ	свѧ́тъ
ст҃ы	свѧты
ст҃ѣ	свѧтѣ
ст҃ѧ	свѧтѧ
Ст҃	Свѧт
сꙋⷠ҇	сꙋббо́та
Cꙋⷠ҇	Cꙋббо́та
сщ҃е	свѧще
сщ҃а	свѧща
сщ҃є	свѧщє
сщ҃ꙋ	свѧщꙋ
Сщ҃	Свѧщ
сⷯ	сти́хъ
трⷪ҇ц	Тро́иц
Трⷪ҇ц	Тро́иц
трⷪ҇ч	тро́ич
Трⷪ҇ч	Тро́ич
трⷭ҇т	трисвѧт
Трⷭ҇т	Трисвѧт
триⷤ	три́жды
Триⷤ	Три́жды
у҆чн҃и	у҆чени
Оу҆ч҃ни	Оу҆чени
у҆ч҃ни	у҆чени
Оу҆ч҃н	Оу҆чен
у҆ч҃н	у҆чен
Оу҆чн҃к	Оу҆ченик
у҆чн҃к	у҆ченик
Оу҆чн҃ц	Оу҆чениц
у҆чн҃ц	у҆чениц
Оу҆чт҃л	Оу҆чи́тел
у҆чт҃л	у҆чи́тел
Оу҆ч҃нї	Оу҆че́нї
у҆ч҃нї	у҆че́нї
Оу҆ч҃те	Оу҆чи́те
у҆ч҃те	у҆чи́те
Оу҆ч҃тл	Оу҆чите́л
у҆ч҃тл	у҆чите́л
хрⷭ҇т	Христ
Хрⷭ҇т	Христ
х҃с	Христо́съ
цр҃е	царе
Цр҃е	Царе
цр҃є	царє
Цр҃є	Царє
цр҃и	цари
Цр҃и	Цари
цр҃ї	ца́рї
Цр҃ї	Ца́рї
цр҃ква	це́рква
Цр҃ква	Це́рква
цр҃кве	церкве́
Цр҃кве	Церкве́
цр҃кви	це́ркви
Цр҃кви	Це́ркви
цр҃квь	це́рковь
Цр҃квь	Це́рковь
цр҃ков	це́рков
Цр҃ков	Це́рков
цр҃ко́в	церко́в
Цр҃ко́в	Церко́в
цр҃кѡ́в	церкѡ́в
Цр҃кѡ́в	Церкѡ́в
цр҃с	ца́рс
Цр҃с	Ца́рс
цр҃ц	цари́ц
Цр҃ц	Цари́ц
цр҃ь	ца́рь
Цр҃ь	Ца́рь
цр҃ѣ	царѣ
Цр҃ѣ	Царѣ
цр҃ю	царю
Цр҃ю	Царю
цр҃ѧ	царѧ
Цр҃ѧ	Царѧ
црⷭ҇к	ца́рск
Црⷭ҇к	Ца́рск
црⷭ҇т	ца́рст
Црⷭ҇т	Ца́рст
чеⷦ҇	человѣ́къ
Чеⷦ҇	Человѣ́къ
чл҃вѣ	человѣ
Чл҃вѣ	Человѣ
чл҃к	человѣк
Чл҃к	Человѣк
чтⷭ҇а	чи́ста
Чтⷭ҇а	Чи́ста
чтⷭ҇е	че́сте
Чтⷭ҇е	Че́сте
чтⷭ҇ї	чи́стї
Чтⷭ҇ї	Чи́стї
чтⷭ҇н	че́стн
Чтⷭ҇н	Че́стн
чтⷭ҇о	чи́сто
Чтⷭ҇о	Чи́сто
чтⷭ҇ꙋ	чи́стꙋ
Чтⷭ҇ꙋ	Чи́стꙋ
чтⷭ҇ъ	чи́стъ
Чтⷭ҇ъ	Чи́стъ
чтⷭ҇ы	чи́сты
Чтⷭ҇ы	Чи́сты
чтⷭ҇ь	че́сть
Чтⷭ҇ь	Че́сть
чтⷭ҇ѣ	чи́стѣ
Чтⷭ҇ѣ	Чи́стѣ
чⷭ҇та	чи́ста
Чⷭ҇та	Чи́ста
чⷭ҇те	че́сте
Чⷭ҇те	Че́сте
чⷭ҇тї	чи́стї
Чⷭ҇тї	Чи́стї
чⷭ҇тн	че́стн
Чⷭ҇тн	Че́стн
чⷭ҇то	чи́сто
Чⷭ҇то	Чи́сто
чⷭ҇тꙋ	чи́стꙋ
Чⷭ҇тꙋ	Чи́стꙋ
чⷭ҇ты	чи́сты
Чⷭ҇ты	Чи́сты
чⷭ҇тѣ	чи́стѣ
Чⷭ҇тѣ	Чи́стѣ
